агфл - агфляція
абвер - абвер
абищиц - абищиця
абсцис - абсциса абсцисовий
абісал - абісаль абісальний
аванзал - аванзал аванзальний
аванкамер - аванкамера аванкамерний
авантюр - авантюра    кіноавантюра
авдит - авдит    енергоавдит
авдієнц - авдієнційний авдієнція
пліч - плічко
гол - голизна
голуб - голубизна
дар - даровизна даровиця
дід - дідизна
матер - материзна
пізн - пізненький пізній пізнісінький пізнуватий    середньопізній
мал - мализна
міл - мілизна
нов - новизна
подоб - подобизна
руд - рудизна
плагіат - плагіатний плагіатник плагіатниця плагіатор плагіаторка плагіаторство плагіаторський  антиплагіатний плагіат  автоплагіат антиплагіат кіноплагіат самоплагіат
ряб - рябизна
син - синизна
сив - сивизна
польщ - польщизна
плоск - плоский плоскість плоскуватий    квазіплоский неплоский суперплоский
сір - сіризна
стар - старизна
трут - трутизна
прадід - прадідизна
прям - прямизна
жовт - жовтизна
мертв - мертвизна мертвеччина
лів - лівизна
дешев - дешевизна
автол - автол автолови
автоном - автономізаційний автономізація автономізм автономізований автономізувати автономізуватися автономійний автономіст автономістичний автономістка автономістський автономічний автономія автономка автономний автономність
автор - автор авторизований авторів авторка авторство авторський авторинг  кіноавтор співавтор
авіа - авіатор авіація
авіамат - авіаматка
авіац - авіація авіаційний
агат - агат агатовий
агроном - агроном агрономічний агрономія агрономка агрономський
адамант - адамант
аджик - аджика
адмірал - адміралка
адрес - адреса    псевдоадреса вебадреса
аеров - аерований
аеронавт - аеронавт аеронавтика аеронавтка
аероном - аерономія
айкідо - айкідо айкідоїст
айті - айтівець айтівка айтівиця айтішний айтішник айтішниця
баліст - балістика балістичний
акванавт - акванавт акванавтика
акварел - аквареліст акварелістка акварель акварелька акварельний акварельність
аквізит - аквізитор аквізиційний аквізиція
аксакал - аксакалка
акушер - акушер акушерка акушерство акушерський акушерування акушерувати
акц - акційний акційований акціонізм акція акціювання
алое - алое алоевий алоеподібний алоеподібність
алтей - алтей алтейний
алтин - алтин
альков - альков альковний
альпак - альпака
анамн - анамнез анамнія
антином - антиномічний антиномічність антиномія
антипірин - антипірин
антисипац - антисипаційний антисипація
апог - апогей апогейний
аптек - аптечка аптечний   мініаптечка
аркатур - аркатура аркатурний
арнік - арніка
арій - арійка арійний арійство арійський
аудит - аудит    енергоаудит
ашкеназі - ашкеназі ашкеназький
багі - багі багіст
байопік - байопік
балбер - балбера балберка
балик - балик баликовий баличок
башлик - башлик башличок
балк - балка балковий   безбалковий міжбалковий
бандж - банджо банджист
банк - необанк
банч - банчок
барбекю - барбекю барбекюшниця
бард - бардеса
барн - барн
баро - необароковий необароко
барок - бароковий бароковість
барооперац - бароопераційна бароопераційний
барій - барій барійний барієвий
батарей - батарейний    безбатарейний контрбатарейний
батьковбій - батьковбійниця
бахаї - бахаїзм бахаїстський
бджоловжал - бджоловжалення бджоловжалювання
бедж - бедж беджик
бейдж - бейдж бейджик
бензоат - бензоат
бентлі - бентлівський
бетеер - бетеер
беших - бешиха
бобер - бобер
бобчук - бобчук
богодан - богоданий богоданість
больверк - больверковий больверк
бореа - бореазми бореальний
боєготов - боєготовий боєготовність
брайтсток - брайтсток
брандмауер - брандмауер брандмауерний
брейнринг - брейнринг
бридж - бридж бриджистка
брокеридж - брокеридж
брудер - брудер брудерний
будд - необуддистський
бунчук - бунчук бунчуковий
буржуаз - необуржуазний
бушрейндж - бушрейнджер
бібліотек - бібліотечка бібліотечний    внутрішньобібліотечний
бій - водобій водобійний
біл - біловий
білатер - білатеральний білатеральність білатеризм білатералізм
білов - білований
білооч - білоочка
білотал - білотал
білотка - білотка
білотурка - білотурка
більшов - необільшовизм необільшовик
біоном - біономічний біономія
біонік - біонік біоніка
біонік - біонік біоніка
біоніч - біонічний
бісер - бісер бісерний
в'їст - в'їсти в'їстися
вайбер - вайбер
валент - бівалент бівалентний бівалентність    псевдобівалент
валют - бівалютний
валіснер - валіснерія
вандал - вандалка    антивандальний антивандальність
вантажоперевал - вантажоперевалка вантажоперевальний вантажоперевалювання
вапн - вапно вапнування вапняк вапняковий вапнувальний вапняний
вапновипал - вапновипалювальний вапновипалювання
васал - васалка васальний
вбран - вбраний вбрання вбраннячко     етновбрання невбраний супервбрання термовбрання
вбрат - вбрати вбратися
вверн - ввернутий
ввігн - ввігнути ввігнутися ввігнаний ввігнати ввігнатися ввігнутий ввігнутість    двоввігнутий
ввігн - ввігнутий ввігнутість   двоввігнутий
ввімкн - ввімкнений ввімкненість ввімкнення ввімкнутий ввімкнутість    самоввімкнення
ввічл - ввічливий ввічливість  взаємоввічливий взаємоввічливість неввічливий неввічливий неввічливість суперввічливий
вгнут - вгнутість
вгор - вгоряння
вгорн - вгорнений вгорнутий
вграт - вграти
вгріт - вгріти вгрітися
вдосконал - вдосконалений вдосконалення вдосконалюваний вдосконалювання вдосконалювач вдосконалювачка    невдосконалений
вектор - бівектор
вектор - вектор векторний    багатовекторний безвекторний двовекторний моновекторний мультивекторний одновекторний полівектор полівекторний псевдовектор псевдовекторний різновекторний семивектор тривектор тривекторний
велич -  велич величний величність
велосит - велосит
верн - вернений   самовернення
верст -  п'ятиверстий триверстий
верств - верствувати верствуватися
весл - веслувальний   безвеслий одновеслий
весн - веснування весняний веснянка весняночка  пізньовесняний ранньовесняний
вестерн - вестерн вестернізм вестернівський
взнан - взнаний
вивал - вивалений вивалюваний вивалювання
вивій - вивіюваний вивіювання
вивіш - вивішати
вигин - вигин
вигн - вигин вигнути вигнутий вигнутися вигнутість вигнуття
вигна - вигнаний вигнання вигнати вигнатися    самовигнання
вигни - вигнити
видув - видувальний видувальник видувальниця видування видувати видуватися
видут - видути видутися
визив - визивний визивність
визнан - визнаний визнаність визнання  взаємовизнаний взаємовизнання загальновизнаний загальновизнаність невизнаний невизнаність невизнання псевдовизнання самовизнання
визнат - визнати визнатися
вийт - вийти
вим - вим'я вим'яти
вим - вимівка
вимив - вимивний
вимит - вимити вимитися
вимов - вимовний вимовність     важковимовний важковимовність легковимовний невимовний невимовність
вимол - вимолений
вимоч - вимочка
виміш - вимішати вимішатися
виниз - винизувати винизуватися
випал - випальний випальність випалювання  безвипальний
випин - випин випнений
випит - випит
випит - випити
випл - виплювати виплюватися
випн - випнути випнутися
випн - випнутий    невипнутий
випіч - випічка
вирлач - вирлач
вирок - вирок   самовирок
виріз - вирізальний вирізувальний вирізування
виріз - вирізувати вирізуватися
вирій - вирій
виріст - виріст
виріш - вирішати вирішатися
висал - висалюваний висалювання
виск - висковий
висмал - висмалений висмалювання
висмій - висміюваний висміювання
виснов - висновування висновувати висновуватися виснуваний виснувати
висов - висовуваний висовування висовувати висовуватися
висув - висування висуваний висувати висуватися    невисування самовисування самовисуватися
висів - висів висівний
висій - висіюваний висіювання
висіч - висічка
витату - витатуйований витатуюваний витатуйовувати витатуювати
витич - витичка витичний
виток - витоковий
витрал - витралений витралюваний витралювання
витруй - витруювання
вихвал - вихвалка вихвалювання
вихват - вихватка
вичекан - вичеканий
вичисл - вичислений вичислювальний вичислюваний
вичист - вичистка
вичорн - вичорнений вичорнення вичорнити вичорнитися
вичув - вичуватися
вишн - вишневий вишник вишнівка вишня вишняк вишнячок
вкрив - вкривний вкривність
вкрит - вкрити вкритися
влов - газовловний
вм'ят - вм'яти вм'ятися
вм'ят - вм'ятина вм'ятинка
вмін - вміння вміннячко    невміння
вміст - водовміст
вовн - вовниця вовняність вовняний вовнянка    напіввовняний
вовч - вовча вовчатко вовченя вовченятко вовчий вовчик вовчиця вовчище вовчук
водолист - водолистий
водолій - водолій
водопій - водопій водопійний
вокал - вокальний вокальність    антивокальний невокальний невокальність
вокат -  вокативний
воск - восковий    невосковий
воскобій - воскобій воскобійний воскобійник воскобійниця
восьмисот - восьмисотий
воєначал - воєначальник воєначальниця
вплесн - вплеснутий
вплив - вплив    взаємовплив етновплив самовплив телевплив
впорсн - впорснення впорснутий
впхн - впхнутий
впхнут - впхнутий
вселен - вселений вселення вселенський вселенськість
вселян - вселяння
всрат - всратися
вткан - втканий
вткнут - вткнутий
вуглевипал - вуглевипалювання вуглевипалювальний
вуду - вудуїзм вудуїст вудуїстка вудуїстський
вузк - вузенький вузесенький вузісінький вузький вузькість    великовузовий невузький ультравузький
вутл - вутлий вутлість вутленький
вчен - вчення    невчення псевдовчення
вчін - вчіння
вівц - вівця
вівцематк - вівцематка
відбив - відбивний відбивність
відбув - відбування
відбій - відбій відбійний відбійник
відвал - відвальний  безвідвальний двовідвальний
відвал - відвальник відвальниця відвалювання     безвідвалка
відвич - відвичка
відвій - відвіюваний відвіювання
відвіч - відвічний відвічність
відгин - відгин
відгнит - відгнити
віддал - віддальний віддалювання
віддан - відданий відданість віддання    взаємовідданий невідданий
віддзеркал - віддзеркальний віддзеркалювання віддзеркалений віддзеркалення віддзеркалюваний віддзеркалювач
віддув - віддування
віддяк - віддяка віддячка
відер - відерний відерник   восьмивідерний двовідерний
відер - тривідерний чотиривідерний
віджей - віджей
віджив - відживний
віджит - віджити
віджов - віджований віджовування віджовувати
віджув - віджувати
відзнач - відзначка
відзнят - відзняти
відкрив - відкривний    самовідкривний
відлив - водовідлив водовідливний
відмив - відмивний
відмит - відмити відмитися
відмич - відмичка
відмов - відмовний    безвідмовний безвідмовність невідмовний невідмовність
віднов -   легковідновний самовідновний
віднов - відновний    важковідновний важковідновність енерговідновний невідновний
віднят - відняти віднятися
відпал - відпальний відпальник відпалювання
відпит - відпити відпитися
відплив - відплив відпливний
відпльов - відпльовування
відпльов - відпльовувати відпльовуватися
відплюв - відплювати відплюватися
відполот - відполоти
відр - відро відровий
відрив - відрив відривний    безвідривний безвідривність невідривний невідривність
відрит - відрити відритися
відріз - відрізальний відрізувальний відрізування
відріз - відрізувати відрізуватися
відсов - відсовування відсувальний відсуваний відсування
відстроч - відстрочка
відстій - водовідстійник
відстій - відстій відстійний відстійник
відсів - відсів відсівний
відсій - відсіювання
відсік - відсік відсічка відсічний     мотовідсік
відтат - відтати
відтин - відтин
відтят - відтяти
відтік - відтік
відчай - відчаюга
відчал - відчалювання
відчит - відчит
відчув - відчуваний відчування
відчув - відчувати відчуватися    самовідчування
відчут - відчути відчутися
відчут - відчути відчутися
відігн - відігнення відігнутий відігнаний відігнання відігнати відігнатися відігнути відігнутися
відіпн - відіпнутий
відітн - відітнення відітнутий
візант - неовізантизм неовізантієць неовізантійський
військмор - військмор
військпрок - військпрок
вікн - вікнастий вікно   євровікно радіовікно фотовікно
вікторіан - неовікторіанство неовікторіанський
вікінг - вікінг вікінгський
вірознан - вірознання
віріал - віріал віріальний
вітал - неовіталізм
віцинал - віциналь віцинальний
газ - газований газованка
газ - газовий
гармон - бігармонійний бігармонійність бігармонічний
гарн - гарненький гарнесенький гарний гарнісінький гарнішати гарнюсінький   негарний негарність супергарний
гаряч - гарячий гарячка   негарячий
гафн - гафнієвий гафній
гегельян - неогегельянець неогегельянство
гепенінг - гепенінг
гетеросекс - гетеросексуалка гетеросексуал гетеросексуалізм гетеросексуаліст
гладіатор - гладіатор гладіаторка гладіаторський
глетчер - глетчер глетчерний
глиновал - глиновальня глиновальковий
глобал - неоглобалізм неоглобаліст неоглобалістський
гнут - гнуття
голов - головний головування головувати    одноголовий п'ятиголовий семиголовий слабоголовий співголовування співголовувати триголовий трьохголовий чорноголовий чотириголовий
головотес - головотес головотеса головотество головотеський головотество головотеський
гомосекс - гомосексуалка гомосексуал гомосексуалізм гомосексуаліст гомосексуалістка
готика - неоготика неоготичний
готов - готовий
грайндкор - грайндкор
грам - біграма
грій - водогрійка водогрійний
гувернер - гувернер
гугл - гугління
гугн - гугнити гугніння гугніти
гуман - неогуманізм
гідров - гідрований
гідрон - гідроновий
гідронавт - гідронавт гідронавтка
гідроном - гідрономія
гіперестез - гіперестез
гіпомнез - гіпомнезія
гіпсовипал - гіпсовипалювальний гіпсовипалювання
гіратор - гіратор гіраторний
гірч - гірчиця
давн - давнезний давненький давній давнісінький давністика давність   недавненький недавній стародавній стародавність
дарвін - неодарвінізм неодарвініст неодарвіністський
дарджилінг - дарджилінг
дафн - дафнія
двохсот - двохсотий двохсотка
двояк - двояк
двоякіс - двоякість
деаер - деаерування
дев'ятисот - дев'ятисотий
декор - декор супердекор
демередж - демередж демереджевий
демпінг - демпінг демпінговий демпінгування    антидемпінг антидемпінговий
держ - держатель
держак - держак держаковий держакція
держалк - держалко
держалн - держално
держидерев - держидерево
держиморд - держиморда
держхолдинг - держхолдинг
дерн - дернацький дернистий дерновий дернувати дернуватися
дерн - дернування дернуватий
десигн - десигнат
десн - десниця
десят - десятина десяцький
детабу - детабуйований
дешев - дешевий дешевість дешевенький    недешевий супердешевий ультрадешевий
джендж - дженджик
джинго - джингоїзм джингоїст джингоїстський
дзижч - дзижчалка дзижчання дзижчати
дзюдо - дзюдоїст дзюдоїстка дзюдоїстський парадзюдоїст парадзюдоїстка
дидаскал - дидаскалка дидаскал
дизайн - неодизайн
дизентер - дизентерія
дисгармон - дисгармоніювати дисгармоніюватися
диск - диск дисковий дводисковий
дистил - бідистильований
дитсанатор - дитсанаторій
дмух - дмухонути
добробат - добробат
довб - довбонути
довмит - довмитися
довій - довіюваний довіювання
довіч - довічний довічність
довіш - довішати
догн - догнути догнутися
дожат - дожати дожатий дожатися
дожин - дожин недожин
дожит - дожити дожитися
дожув - дожований дожовуваний дожовування дожовувати дожувати
дознат - дознати дознатися
дознят - дозняти дознятися    недозняти
дозор - дозор
докрит - докрити
докрів - недокрівний
дом'ят - дом'яти
домен - доменник
домит - домити домитися
домліт - домліти
домн - домна домниця  дводомний дводомність електродомна однодомний однодомність багатодомний
доміш - домішати домішатися
донатор - донатор донаторка донаторський
донац - донація
дониз - донизування донизувати донизуватися
донор - донор
доотруй - доотруювати
доп - допований допування
доп - допований допування
панщ - панщизняний панщинний
папк - папковий
допал - допалювання допалений допалення допалювальний допалюваний допалювач    недопал недопалений недопалок
допит - допит     відеодопит
допит - допити допитися     недопити недопитися
допн - допнути допнутися
допрат - допраний допрати
допріт - допріти
допінг - допінг допінговий допінгування   антидопінговий
допіч -  недопічка
дор - автодор автодорівець
дорван - дорваний
дорват - дорвати дорватися
дорит - дорити доритися
дорос - доросленький дорослішати
доріз - дорізування
доріз - дорізувати дорізуватися
дорік -  недоріка
дослан - досланий дослання дослати
дослів - дослівний дослівник
досмал - досмалений досмалюваний досмалювання
доснит - доснитися
доспат - доспати доспатися    недоспаний недоспати
доспіти - доспіти недоспіти
доссат - доссати доссатися
достат - достатися
досхнут - досхнути
дотац - дотаційний дотація   бездотаційний держдотація держдотаційний соцдотація недотаційний
дотик - дотик дотичний дотичність  недотика недотичний недотичність
доткат - дотканий доткати доткатися
доткл - доткливий доткливість
доткн - доткнутися
дотліт - дотліти
дохл -  дохлий дохнути     напівдохлий
дохов - дохований доховування доховувати доховуватися
дочув -  дочувати дочуватися дочути дочутися    недочування недочувати недочути
дошит - дошити дошитися    недошити
дошк -  дошка
дубл - дублений дублення дублювальний дублювання дублювати дублюватися дублянка    кінодублювання недублений
дівер - дівер діверка
діджей - діджей діджейство діджейський
дійт - дійти дійтися
дієз - дієз
еверн - евернія
его - вузькоегоїстичний
ейдж - ейджизм ейджист ейджистка ейджистський
екзосфер - екзосферний
екотон - екотон екотонний
екотоп - екотоп екотопічний
ексабайт - ексабайт
ексгібіц - ексгібіціонізм ексгібіціоніст ексгібіціоністка ексгібіціоністський
екседр - екседра
ексерг - ексергія ексергетичний
ексик - ексикатор ексикація
ексим - ексимерний
екситон - екситон екситонний
екситотокс - екситотоксин
екситрон - екситрон
екскав - екскаватор екскаваторний екскаваторник екскаваторниця екскаваційний екскавація
екскаваторобуд - екскаваторобудівний екскаваторобудування
ексклав - ексклав
екскор - екскоріація
екскорт - екскортниця
екскр - екскреторний
екскремент - екскремент екскрементний
екскрет - екскретований
екскрец - екскреція
екскурс - екскурс екскурсійний екскурсія    авіаекскурсія аудіоекскурсія велоекскурсія відеоекскурс відеоекскурсія екоекскурсія телеекскурсія
екскурсант - екскурсант екскурсантка екскурсантський
екскурсовод - екскурсовод екскурсоводка екскурсоводський
екскурсознав - екскурсознавець екскурсознавство
екслібрис - екслібрис екслібрисист екслібрисний    суперекслібрис
ексм - ексмер ексмерка
ексон - ексон
ексопозиц - ексопозиційний
експ - експат експатка
експанс - експансивний експансивність експансійний експансіонізм експансіоніст експансіоністський експансія
експатр - експатріація експатрійований
експатріант - експатріант експатріантка
експед - експедований експедування
експедир - експедируваний
експедит - експедитор експедиційний експедиція    велоекспедиція етноекспедиція кіноекспедиція
експедитор - експедиторка експедиторський
експект - експектація
експеримент - експеримент експериментальний експериментальність експериментатор експериментаторка експериментаторство експериментаторський експериментований експериментування    біоексп
експериментал - експерименталізм
експерт - експерт експертка експертний експертність    авіаексперт агроексперт антиекспертний біоексперт внутрішньоекспертний держексперт енергоексперт квазіексперт кіноексперт псевдоек
експертиз - експертиза    агроекспертиза відеоекспертиза держекспертиза екоекспертиза псевдоекспертиза
експертолог - експертологія
експланатор - експланаторність
експлант - експлант експлантат експлантаційний експлантація
експлет - експлетивний
експлоз - експлозивний експлозивність експлозія
експлор - експлоратор
експлуат - експлуататор експлуататорка експлуататорський експлуатаційний експлуатація експлуатований експлуатування    самоексплуатація
експлуатант - експлуатант
експлуатац - експлуатаційник
експлік - експлікативний експлікатор експлікаційний експлікація експлікований експлікування
експліцит - експліцитний експліцитність    неекспліцитний
експозиметр - експозиметр
експозит - експозитивний
експозитур - експозитура
експозиц - експозиційний експозиційність експозиціоністка експозиція    відеоекспозиція двоекспозиційний мегаекспозиція неекспозиційний фотоекспозиція
експон - експонат експонований експонувальний експонування    неекспонований фотоекспонат
експон - експонувати експонуватися
експонат - експонатний
експонатур - експонатура
експонен - експоненційний    неекспоненційний
експонент - експонент експонента експонентний
експоненц - експоненціальний    неекспоненційність
експонометр - експонометр експонометричний експонометрія    фотоекспонометр
експоплощ - експоплоща
експоплощ - експоплоща
експорт - експорт експортер експортерка експортний експортований експортування    автоекспортер агроекспорт агроекспортер газоекспорт газоекспортний неекспортний псевдоекспорт псевдоекс
експортноорієнт - експортноорієнтований
експортозалеж - експортозалежний експортозалежність
експортоорієнт - експортоорієнтований експортоорієнтованість
експортоспромож - експортоспроможний експортоспроможність
експоцентр - експоцентр
експропр - експропріатор експропріаторський експропріаційний експропріація експропрійований експропріювання
експір - експіраторний експіраційний експірація
екст - екстатичний екстерний
екстаз - екстаз
екстат - екстатичність
екстинк - екстинкція
екстирп - екстирпатор екстирпаторний екстирпаційний екстирпація
екстрим - екстрим
екструд - екструдер екструдований екструдування
екструз - екструзивний екструзійний екструзія    гідроекструзія
екстурагент - екстурагентка
ексуд - ексудат ексудативний ексудація
ексфол - ексфоліативний ексфоліація
ексцедент - ексцедентний
манат - манат
ексцелен - ексцеленція
ексцентр - ексцентризм ексцентрик ексцентрика ексцентричний ексцентричність
ексцентрик - ексцентриковий
ексцентриситет - ексцентриситет
ексцентріад - ексцентріада
ексцес - ексцес ексцесив ексцесивний
ексцес - ексцес ексцесив ексцесивний
ексциз - ексцизія
ексцит - ексцитативний
ексцитат - ексцитативний
ел - ель
електрозапал - електрозапал електрозапалювання
електрон - електроновий
електронік - електроніка
електронік - електроніка
електроопал - електроопалення електроопалювальний електроопалювання
електропорацій - електропорація
ескіз - ескіз ескізний ескізування ескізувати
етн - біетнічний
жироспал - жироспалювальний жироспалювання жироспалювач
життєдій - життєдіяльний життєдіяльність  нежиттєдіяльний
жмен - жменя жменька
жовн - жовно жовнуватий
жонгл - жонглереса
жорн - жорно жорновий
журнал - журнальний журналювання    кіножурнальний
забез - соцзабез
забив - забивний
забив - забивний
забит - забити забитися
забит - забити забитися
заблюв - забльований забльовувати забльовуватися
заблюв - заблювати заблюватися
заблюв - заблювати заблюватися
забув - забування забувати забуватися
забув - забування забувати забуватися забути забутися
забут - забути забутися
забій - забій забійний забійник забійниця    багатозабійний багатозабійність
зав'ят - зав'яти
завал - завалка завальний завалювання
завзят - завзятися
завив - завивний
завит - завити завитися
завич - завичка
завтій - затійниця
завіз - завізований
завіз - завізувати
завій - завій завійка завійний завійниця завіювання завія
завіш - завішати
загал - загальний загальник загальниця загальність    незагальний
загат - загатка
загин - загин
загн - загнений загнути загнутий загнутися загнуття
загнан - загнаний загнаність загнання загнати загнатися
загнит - загнити загнитися
загран - заграний
заграт - заграти загратися
задан - заданий заданість задання
задат - задати задатися
задніт - задніти
задув - задувальник задування задувати задуватися задути
задій - задіювання
задіт - задіти задітися
зажат - зажати
зажер - зажерний
зажив - заживний
зажин - зажин
зажит - зажити зажитися
зажнив - зажнивний
зажов - зажований зажовувати зажовуватися зажувати
зазив - зазивний
зазнан - зазнаний зазнання    незазнаний
зазнат - зазнати
зазнач - зазначка
зазор - зазор
зайт - зайти зайтися
зайч - зайча зайчатко зайченя зайченятко зайчик зайчиця
заклан - заклання   самозаклання
заклик - заклик закличний    відеозаклик
заклин - заклин
закльов - закльований закльовуваний закльовувати закльовуватися
заклюв - заклювати
заков - закований заковуваний заковування заковувати заковуватися закування закувати закуватися
закрив - закривний
закрит - закрити закритися    напівзакрити напівзакритися
закрохмал - закрохмалений закрохмалюваний закрохмалювання
закрій - закрій закрійний закрійник закрійниця самозакривний
закут - закути
зам'ят - зам'яти зам'ятися
замал - замалювання
замит - замити замитися
замк - замковий замчище
замов - держзамовний
замов - замовний замовність
замок - електрозамок пневмозамок
замок - замок замочок   автозамок беззамковий гідрозамок суперзамок
замор - замор
заміш - замішати замішатися
запаюв - запаювальник запаювальниця
запівніч - запівнічний
зарин - зарин
зарит - зарити заритися
зарн - зарнути
зарок - зарок
зарік - зарік
заріст - заріст зарість
заріч - зарічок
засал - засалювання
заск - заскок заскочка
заскал - заскалка заскалювання
заскл - засклений засклення заскління    незасклений
заскн - заскніння
заслан - засланий
заслат - заслання заслати заслатися
засмал - засмалений засмалення засмалювання
заснов - заснований заснованість засновання засновний засновуваний засновування засновувати засновуватися  новозаснований
заснув - заснування заснувати заснуватися    співзаснувати
заснут - заснути
заснів - заснівка
засов - засовування
засов - засовувати засовуватися
засув - засування
засув - засувати засуватися
засхн - засхнути
засцят - засцяти
засів - засів засівний
засів - засівна
засій - засіювання
засік - засік засіка
засіч - засічка засічний
затабу - затабуйований затабуйованість
затич - затичка
затн - затнути затнутися
затон - затонути
затор - затор    автозатор
заточ - заточка
затят - затяти затятися
захвал - захвальний захвалений захвалювальний захвалюваний захвалювання
захват - захват
захедж - захеджувати
захис - захист
захист - біозахист віброзахист водозахист гідрозахист держзахист звукозахист зоозахист кіберзахист напівзахист псевдозахист радіозахист самозахист соцзахист спецзахист суперзахист теплозахист термозахист
захмиз - захмизувати
захов - захований захованість заховання заховування заховувати заховуватися
захтіт - захтіти захтітися
зачат - зачати зачатий зачатися
зачин - зачин
зачист - зачистка
зачут - зачути зачутися
кітч - кітч кітчевий кітчевість
лакей - лакейчукувати
зашив - зашивний
кросн - кросна кросно
зашит - зашити зашитися
зашкал - зашкальний зашкалювання зашкалений зашкалення
котурн - котурн котурновий котурняність
заісн - заіснувати
збагн - збагнений збагнення збагнутий    незбагнений незбагнутий
звук - звуковий
керн - керновий кернування кернувати
згріт - згріти
згріш - згрішати
зл - злюка злий
консигн - консигнатор консигнаційний консигнація
колумн - колумніст колумністика колумністичний колумністка
ільк - ільковий
ільн - ільняний
знекрохмал - знекрохмалювання
зотл - зотління
кавер - кавер
каверн - каверна    псевдокаверна
зотн - зотнутий
капер - капер каперство каперський
зів'ят - зів'яти
зігн - зігнений зігнення зігнутий    напівзігнутий незігнутий
зігн - зігнути зігнутися зігнутість    напівзігнути напівзігнутися напівзігнутість
зігнан - зігнаний зігнання
зігнат - зігнати
зігнит - зігнити
зім'ят - зім'яти зім'ятися
зімкн - зімкнений зімкненість зімкнення зімкнутий зімкнутість    незімкнений
зітл - зітління зітнутий
зітн - зітнути зітнутися
зогн - зогнити
зурн - зурна зурнач зурніст
какао - какао какаовий
камер - бікамеральний
камерал - бікамералізм
кан - каня
канал -   одноканальність різноканальний
канал -  моноканальний
канал - водоканальник міжканальний
канал - канальний каналювання  багатоканальний багатоканальність безканальний безканальність внутрішньоканальний восьмиканальний двоканальний двоканальність мікроканальний мультиканальний п'ятиканальний середньоканальний телеканальний триканальний триканальність чотириканальний чотириканальність шестиканальний
канат - канат канатка
каное - каноїст каноїстка
кантор - кантор
кантіан - неокантіанець неокантіанство неокантіанський
канут - канути
канюк - канюк канюка
капсул - бікапсульний
капіталіст - неокапіталістичний
карбон - бікарбонат
карбонат - бікарбонатний
карбід - бікарбід
кардіограм - бікардіограма
картридж - картридж картриджний    двокартриджевий
катіон - катіонування
квадр - біквадрат
квадрат - біквадратний
квазіар - квазіарний
квірит - квірит квіритський
квіслінг - квіслінг
кейнсіан -  неокейнсіанець неокейнсіанство неокейнсіанський
кенінг - кенінг
кефал - кефальний    автокефальний автокефальність
киндж - кинджальний
кишен - кишенька кишеня
кишеч - кишечка
клас - неокласик неокласика неокласичний
класиц - неокласицизм неокласицистичний
клаузул - біклаузульність
кобзар - неокобзарство
кол - біколор
коледж - коледж    авіаколедж агроколедж
коледж - коледж    авіаколедж агроколедж
колоніал - неоколонізація неоколоніалізм неоколоніаліст неоколоніалістський
комиз - комизувати
комин - комин
компакт - бікомпактний бікомпактність
компонент - бікомпонентний
комун - неокомуніст
комуніст - неокомуністичний
комінтерн - комінтерн комінтернівський
кон - біконічний
консерв - неоконсервативний
конструк - біконструкція
контор - контора конторка конторник конторниця конторський
контрар - контрарний
контраст - контраст контрастивний контрастний контрастність контрастовий контрастування контрастувати контрастуватися
контратип - контратип контратипування контратипувати
контрмітинг - контрмітинг
конфуціан - неоконфуціанець неоконфуціанство неоконфуціанський
концептуал - неоконцептуалізм
коньяк - коньяк коньяковий коньячок
копер - копер коперний
копч - копченя
копій - копіїст копіїстика копіїстка копіїстський копійка копійний копійник копійність копійований копіювальний копіювальник копіювальниця копіювання копія    аудіокопія відеокопія гідрокопіювальний кінокопіювальний кінокопія мікрокопія псевдокопія самокопіювальний фотокопіювальний фотокопіювання фотокопія
кориц - кориця
корич - коричний
корк - корковий
корок - корок
корпоратив - неокорпоративізм
корів - корівка корівник корівниця корівня
корін - коріння коріннячко
крибедж - крибедж
крибідж - крибідж
кригінг - кригінг
кузен - кузенька
кузн - кузня кузенька   кінокузня телекузня
кузов - кузовний
кулер - кулер
культ - неокульт неокультовий
культур - бікультура бікультурний бікультурність
кумач - кумач кумачевий
кундж - кунджа
кілер - кілер кілерка кілерство кілерський кіберкілер суперкілер
лакей - лак лакей лакейство лакейський
лама - ламаїзм ламаїст ламаїстський
ламарк - неоламаркізм неоламаркіст неоламаркістський
латин - неолатинство неолатинський
левередж - левередж
леверидж - леверидж
легк - легковий
легков - легковичка легковичок легковушка
лексем - неолексема
лемінг - лемінг
лодж - лоджія
ліберал - неоліберал неолібералізм неоліберальний
лібертаріан - неолібертаріанство
лін - білінійний
лінгв - білінгв білінгва білінгвальний білінгвізм білінгвістичний
лінгвіст - неолінгвістика
ліпід - біліпідний
літер - літерка літерний  нелітерний однолітерний трилітерний
літій - літієвий літій літіювання
магарадж - магараджа
магл - маглювання маглювати
магнет - магнетований магнетованість
магнет - магнетовий
мазер - мазер мазерний
мазер - мікромазер
майор - майор    ексмайор псевдомайор
малон - малоновий
мальтузіан - неомальтузіанець неомальтузіанство неомальтузіанський
мануал - мануальний мануальник мануальниця   немануальний бімануальний
маніок - маніок
маркс - неомарксизм неомарксист неомарксистський
масив - масив масивний масивність   біомасив мікромасив немасивний супермасивний
масл - маслений масляний маслянка
масн - масний масниця масність маснуватий
мат - мати біомати прамати
матч - матчевий   десятиматчевий
махарадж - махараджа
мегаліт - мегаліт мегалітичний
мегатер - мегатерій
медколедж - медколедж
медіац - медіація медіаційний
мезосфер - мезосфера мезосферний
мейджор - мейджор
мельхіор - мельхіор мельхіоровий
мендж - менджування
меркантил - неомеркантилізм
меседж - меседж
метазнан - метазнання
месендж - месенджер
месидж - месидж
месидор - месидор
метал - біметал біметалізм
металев - біметалевий
метасоматоз - біметасоматоз
мигдал - мигдальний мигдальник мигдалик мигдаль мигдалюватий
мод - бімодальний бімодальність
модерн - неомодернізм неомодерніст
молекуляр - бімолекулярний
момент - бімомент
монод - монодичний
моноліт - моноліт монолітний монолітність
моном - бімономіальний
моноплан - бімоноплан
морф - біморф біморфний
морфем - біморфема
мотив - мотив мотивний мотивчик     безмотивний безмотивність етномотив мікромотив субмотив
мотор - вазомоторний
моточ - моточок
мікроліт - мікроліт мікролітичний
міністр - міністр міністриня міністрів міністрка
місій - місійний місійність місія   спецмісія супермісія
мітолог - неомітологізм неомітологічний неомітологія
міфолог - неоміфологізм неоміфологічний неоміфологія
набат - набат
набив - набивний
набит - набити набитися
наблюв - наблювати
набряк - набряк набряковий    протинабряковий
набрів - набрівник
набув - набувальний набувальник набувальниця набування набувати набуватися набувач набувачка набути набутися
набій - набій набійка набійний набійник
навал - навалка навалювання
навал - навалка навалювання
навал - навальний навальник навальниця навальність
навал - самонавалювання самонавалення
наверн - навернений навернення навернутий
навив - навивний
навив - навивний навити навитися
навит - навити навитися
навич - навичка
навич - навичка
навтіш - навтішатися
навій - навійний навіюваний навіювальний навіюваність навіювання  взаємонавіювання самонавіюваність самонавіювання
навіч - навічний
навіш - навішати
нагал - нагальний нагальність
нагин - нагин
нагл - наглий наглість
нагн - нагнути нагнутися нагнутий нагнуття
награн - награний награність награти награтися  ненаграний
нагрів - нагрів нагрівний нагрівник
нагріт - нагріти нагрітися    водонагрів водонагрівний водонагрівник електронагрів електронагрівний електронагрівник  самонагрів самонагрівний
надан - наданий наданість надання
надат - надати надатися
надбан - надбаний надбання
надбан - новонадбаний
надбат - надбати
надбит - надбити надбитися
надгнит - надгнити
надит - надити надитися
надков - надкований надкувати
надкол - надклювати
надпит - надпити
надр - надровий
надран - надраний
надрат - надрати надрив
надрив - надривний надривність    мікронадрив ненадривний
надріз - надрізування надрізувати надрізуватися
надточ - надточка
надтят - надтяти
надув - надувальний надуваний надування надувати надуватися
надут - надути надутися
надшит - надшити
надігн - надігнутий
надій - надій надійний надійність  надія
надіт - надіти надітися
нажат - нажати нажатися
нажер - ненажерний ненажерство
нажив - нажив наживний
нажин - нажин нажити
нажит - нажитися
найт - найти найтися
накат - накат накатка
наклей - наклейний
накльов - накльований накльовуваний накльовування накльовувати накльовуватися
наклюв - наклювати наклюватися
наков - накований наковання наковування наковувати накування накувати
накрив - накривний
накрит - накрити накритися
накрохмал - накрохмалений накрохмалюваний накрохмалювання    ненакрохмалений
налив - налив наливний    водоналивний газоналивний напівналивний нафтоналивний
налит - налити налитися наличка
наллят - налляти наллятися
нам'ят - нам'яти нам'ятися
намив - намив намивний    гідронамив
намит - намити намитися
наміш - намішати намішатися
нан - нанізм
наниз - нанизувальний нанизування нанизувати нанизуватися
нанк - нанка нанковий
напит - напити напитися
наплюв - наплювальний наплювати наплюватися
напнут - напнути напнутий напнутися
напран - напраний
напрат - напрати
напсов - напсований
напсув - напсування напсувати напсуватися
напув - напувалка напувальний напувальник напувальниця напування напувати напуватися    автонапувалка автонапувальниця автонапування самонапувалка самонапувальниця
напій - напій
напіч - напічний
нарал - наральник
нарат - наративний наратор нараторка нараторський  ненаративний
нарац - нараційний нарація
нарван - нарваний
нарват - нарвати нарватися
нарив - нарив наривний
нарит - нарити наритися
народ - неонародницький
наріз - нарізальний нарізувальний нарізування нарізувати нарізуватися  самонарізальний
наріст - наріст
нас - наський    ненаський
насал - насалювання
насит - насит
наслан - насланий наслання
наслат - наслати
наснит - наснитися
наснов - насновувати
наснув - наснувати
насов - насовування
насов - насовувати насовуватися
наспан - наспаний
наспат - наспатися
наспів - наспів наспівний
автомат - автомат автоматизатор автоматизаційний автоматизація автоматизм автоматизований автоматизованість автоматизовувати автоматизовуватися автоматизувальний автоматизування автоматизувати автоматизуватися автоматизувальний автоматизування автоматизувати автоматизуватися автоматика автоматичний автоматичність автоматний автоматник автоматниця
спів - співливий
наспіт - наспіти
насрат - насрати
матча - матча
нассат - нассати нассатися
настал - насталювання насталений насталення насталий
настан - настання    ненастання
настат - настати
настій - настій настійний настійність
насув - насувальний насуваний насування
насув - насувати насуватися
насцят - насцяти
насів - насів
насій - насіння
насін - насіннячко
насіч - насічка насічний
натату - нататуйований
натив - нативізм нативіст нативістичний нативний
натхн - натхненник натхнений натхнення натхнутий натхнути натхнутися    ненатхнений
маньяк - маньяк маньякуватий маньячка
натяк - натяк   напівнатяк
натят - натяти
натіч - натічний
нафт - нафтовий
нафт - нафтовище
нахиз - нахизуватися
нахов - нахований
нац - неонацизм неонацист неонацистка неонацистський
фірн - фірновий
начал - начальник начальницький начальниця   багатоначальний багатоначальність ексначальник кіноначальник теленачальник теленачальниця
сосн - сосна сосник сосновий сосняк
начдив - начдив
парапарез - парапарез
урівн - урівнюваний урівнювання урівнювати урівнюватися урівняний урівняння урівняти
стагн - стагнаційний стагнація стагнувати    псевдостагнація
стемн - стемніти стемнітися
суши - сушист сушистка
сталагн - сталагнат
упірн - упірнання упірнати упірнути
сомат - соматичний
прогнат - прогнати прогнатися
таверн - таверна
сфагн - сфагновий
спарингпартн - спарингпартнер
терн - терник терниння тернистий тернистість терниця тернище тернівка терновий терночок
спевн - спевнити
прогнит - прогнити
ревіз - ревізувати ревізуватися
сарн - сарна сарненя сарненятко сарнонька сарночка сарнюк
прогнут - прогнути прогнутися
сарич - сарич
сатурн - сатурнізм сатурнія
правік - правік правічний правічність
передн - переднювати
переджн - переджнивний
серн - серна серненя серненятко
приснит - приснитися
рознят - розняти рознятися
розігнат - розігнаний розігнання розігнати розігнатися    саморозігнання
розігнут - розігнути розігнутися
розор - розор
приснут - приснути
присов - присовувати присовуватися
присув - присувати присуватися
перезнят - перезняти перезнятися
пірн - пірнальний пірнальник пірнальниця пірнання пірнати пірнач пірнути
переснов - переснований пересновування
пересіч - непересічний непересічність
пересув - самопересування
пожн - пожнивний
етнопоп - етнопоп
посів - посівна
попкорн - попкорн попкорновий
перез - перезок
начин - начиння  автоначиння
поясн - пояснений пояснення пояснити пояснитися поясність поясніти пояснішати пояснювальний пояснюваний пояснювання пояснювати пояснюватися пояснювач поясняти пояснятися   важкопояснюваний непояснений непояснюваний псевдопояснення
пікнік - пікнік пікнічний пікнічок
опівніч - опівнічний
одігн - одігнаний одігнати
парц - парційний
начув - начуваний начування начуватися начутися
північ - північний
півн - півник півнячий півня
нашив - нашивний
нашит - нашити нашитися
нашлят - нашлятися
піддн - підднище
неврит - неврит
невус - невус
невіст - невістка
невіст - невістонька невісточка
негоц - негоціація
неоген - неоген неогеновий
неодим - неодим неодимовий
неолог - неологізм неологічний неологія
неоліт - неоліт неолітизація неолітичний неолітовий
неоміцин - неоміцин
неон - неон неоновий
неонатал - неонатальний
неп - непівський
непот - непотизм
нов - надновий
новатор - новатор новаторка новаторство новаторський   псевдоноватор псевдоноваторство псевдоноваторський суперноватор
номер - автономер автономерний
номер - номер номерний   безномерний держномер єврономер спецномер
норм - бінормальний
нормал - бінормаль
нувориш - нувориш нувориський
оббив - оббивний
оббит - оббити оббитися
обблюв - обблювати обблюватися
обвал -   протиобвальний
обвал - обвальний обвалювання
обвал - самообвалювання
обвив - обвивний
обвит - обвити обвитися
обвій - обвіюваний обвіювання
обвіш - обвішати обвішатися
обгорн - обгорнений обгорнення обгорнутий
обдат - обдати обдатися
обдув - обдувальний обдуваний обдування обдувати обдуватися
обдут - обдути обдутися
оберн - обернений оберненість обернення обернутий    взаємообернений самообернення
обжат - обжати обжатий
обжер - обжерний
обжин - обжин
обжит - обжити обжитися
обкат - обкатка
обкльов - обкльований обкльовувати
обков - обкований обковуваний обковування обковувати    необкований
обкув - обкування обкувати
обкут - обкути
облат - облатка
облиз - облизування облизувати облизуватися
облит - облити облитися
облік - облік    авіаоблік водооблік держоблік партоблік спецоблік теплооблік
обмал - обмалювання
обмит - обмити обмитися
обмов - обмовний
обниз - обнизування обнизувати
обнов - обновний
обнят - обняти обнятися
обпал - вуглеобпалювання
обпал - обпальний обпалювання
обпит - обпитися
обпльов - обпльований обпльованість обпльовуваний обпльовування обпльовувати обпльовуватися
обплюв - обплювати обплюватися
обран - обраний обраність обрання  богообраний богообраність загальнообраний необраний необрання новообраний
обрат - обрати обратися
обрив - обрив обривний обривність
оброк - оброк
обріз - обрізальний обрізувальний обрізування обрізувати обрізуватися
обрій - обрій обрійний  телеобрій
обсал - обсалювання
обсмал - обсмалювання
обсмій - обсміюваний обсміювання
обснов - обснований обсновуваний обсновувати обсновуватися
обстат - обстати
обсув - обсування
обсув - обсувати обсуватися
обтят - обтяти
обтік - обтік
обтіч - обтічний обтічність    легкообтічний легкообтічність
обшив - обшивний
обшит - обшити обшитися
огорн - огорнений огорнутий
огорн - огорнути огорнутися
огрів - огрів огрівний огрівник
огріт - огріти огрітися
одбит - одбити одбитися
одбув - одбувати одбути
одбій - одбійний
одверн - одвернений одвернутий одвертість
оддан - одданий оддати
арик - арик ариковий аричок
оддяк - оддяка
оджит - оджити
одлив - одливний
одлит - одлити
одпит - одпити
одсув - одсуватися
одсів - одсівний
одсіч - одсічка
одтят - одтяти
одімкн - одімкнений одімкнутий
одіпн - одіпнутий
одітн - одітнути
озват - озватися
озлит - озлити озлитися
озліст - озлість
ок - багатоокість безокість двоокість чотириокість
окрик - окрик
окрит - окрити
опудал - опудальник
оратор - оратор ораторний
осм - осмистий осмієвий осмій
осмал - осмалювання
осмат - осмат
осмій - осміюваний осміювання    гіперосмія
отруй - отруювання отруювати отруюватися    самоотруювання
охвіст - охвістя
п'ятисот - п'ятисотий п'ятисотка
панік - паніка
паніч - панічний панічність
паплюг - паплюга
папер - паперовик    безпаперовість
пар - напівпар напівпаровий
пар1 - пар пара парене парений парка паркий паркість парний парник парниця парність парня парований паровий парський паруватий
пар2 - пара парувальний парування парочка
парабол - парабола параболічний параболічність парабольний
параван - параван
параліч - параліч паралічний
параметр - параметр параметральний параметризація параметризований параметричний параметровий параметровний
параном - параномія
парапет - парапет парапетний
парасол - парасолеподібний
парасол - парасоль парасолька парасольковий парасольний парасольовий парасоля
парашут - парашут парашутизм парашутик парашутист парашутистка парашутний парашутування
парез - парез
парк - автопарковий гідропарковий зоопарковий
парк - парковий
парн - електропарник
партократ - партократ партократичний
парч - парча
парія - парія
патріарх - неопатріархат
педколедж - педколедж
пейдж - пейджер пейджинг пейджинговий
перебив - перебивний
перебит - перебити перебитися
перебув - перебування перебувати перебуватися   неперебування співперебування
перебут - перебути перебутися
перебій - перебій перебійний    безперебійний безперебійність
перевал - перевалка перевальний перевалювання    нафтоперевалка нафтоперевальний
переверн - перевернений перевернення перевернутий    неперевернутий
перевив - перевивний
перевит - перевити перевитися
перевій - перевіюваний перевіювання
перевіш - перевішати перевішатися
перегин - перегин
перегнан - перегнаний перегнання перегнати
перегнит - перегнити
перегнут - перегнути перегнутий перегнутися перегнуття
перегній - перегній перегнійний
перегран - переграний
переграт - переграти перегратися
перегрів - перегрів перегрівний перегрівник
перегріт - перегріти перегрітися
передан - переданий передання    теплопередання
передат - передати передатися
передач - передачка
передран - передраний передрання
передрат - передрати передратися
передріш - передрішати
передув - передуватися
передут - передути
передчув - передчування передчувати передчуватися
передчут - передчути
пережат - пережати
переждат - переждати
пережит - пережити пережитися
пережов - пережований пережовуваний пережовування пережовувати пережовуватися
пережув - пережувати пережуватися
перезахов - перезахований перезаховання перезаховувати
перездан - перезданий
перездат - перездати перездатися
перезріт - перезріти
перезув - перезування перезувати перезуватися
перезут - перезути перезутися
перейнят - перейняти перейнятися
перейти - перейти перейтися
перекат - перекат
переклей - переклейний
переклик - переклик    радіопереклик
перекльов - перекльовуваний перекльовувати
переклюв - переклювати
переков - перекований перековувальний перековуваний перековування перековувати перековуватися
перекрив - перекрив перекривний    неперекривний неперекривність
перекрит - перекрити перекритися
перекрохмал - перекрохмалений перекрохмалювання
перекрій - перекрій
перекув - перекування перекувати перекуватися
перелив - перелив переливний переливність
перелиз - перелизування перелизувати
перелит - перелити перелитися
переллят - перелляти переллятися
переляк - переляк
перелік - перелік
переліч - перелічний перелічність
перемал - перемалювання
перемит - перемити перемитися
перемич - перемичка перемичний
перемкн - перемкнений перемкнення перемкнутий
перемліт - перемліти
перемов - перемовний
переміш - перемішати перемішатися
перениз - перенизування перенизувати перенизуватися
перепал - перепалка перепалювання
перепин - перепин
перепит - перепит
перепит - перепити перепитися
переплесн - переплеснутий
перепльов - перепльовуваний перепльовувати
переплюв - переплювати
перепнут - перепнути перепнутися
перепран - перепраний перепрання
перепрат - перепрати перепратися
перепріт - перепріти
перепсув - перепсований перепсувати перепсуватися
перепхан - перепханий
перепхат - перепхати перепхатися
перепхнут - перепхнути перепхнутий перепхнутися
перепій - перепій перепійний
перепіч - перепічка
перерал - перералювання
перерив - переривний переривність    непереривний непереривність
перерит - перерити
переріз - перерізувальний перерізування
переріз - перерізувати перерізуватися
переріст - переріст
пересит - пересит
переслан - пересланий переслання
переслат - переслати переслатися
пересмал - пересмалений пересмалювання
пересов - пересовування пересовувати пересовуватися
переспат - переспати переспатися
переспів - переспів переспівниця
переспіт - переспіти
перессат - перессати
перестан - перестання
перестат - перестати
перестій - перестій перестійний
пересув - пересувальний пересуваний пересування пересувати пересуватися
пересів - пересів
пересій - пересіюваний пересіювання
пересіч - пересічка пересічний пересічність
перетин - перетин
переткан - перетканий
переткан - перетканий переткати переткнути
переткат - переткати
переткнут - переткнути
перетліт - перетліти
перетліт - перетліти
перетн - перетнення перетнутий    взаємоперетин самоперетин середньоперетнутий
перетнут - перетнути перетнутися перетнутість
перетруй - перетруювати
перетят - перетяти перетятися
перетік - перетік
перехвал - перехвалений перехвалюваний перехвалювання
перехов - перехований переховання переховування переховувати переховуватися переховувач переховувачка
перечут - перечути
перешив - перешивний
перешит - перешити
перитрих - перитриха
перм'ят - перем'яти перем'ятися
перст - триперстя
пестрюг - пестрюга
пилоспал - пилоспалювання
площин - площина    гіперплощина
плящ - плящина
пневмонік - пневмоніка
пневмоніч - пневмонічний
побган - побганий побганість
побгат - побгати побгатися
побит - побит побити побитися
побран - побраний
побрат - побрати побратися
побрит - побрити побритися
побув - побувати
побут - побути
побій - побій
побіч - побічний
пов'ят - пов'яти
поверн - повернений поверненка повернення повернутий    неповернений неповерненка неповернення неповернутий самоповернення
повзув - повзуваний повзувати повзуватися
повит - повити повитися
повн - повненький повнесенький повний повнісінький повність повня
повріз - поврізувати
повстан - повстання    псевдоповстання
повстат - повстати
повт - повтор повторний
повтіш - повтішати повтішатися
повів - повів
повій - повійка повійниця повія
повік - повіка
повіс - повістка повість
повічн - повічний
повіш - повішати повішатися
погнат - погнати погнатися
погнит - погнити
погнут - погнути погнутися
погнут - погнутий погнутість
погній - погній
пограт - пограти погратися
погріт - погріти погрітися
подан - поданий подання
подат - подати податися
подач - подачка
подбат - подбати
подвійновгн - подвійновгнутий
подвійнозігн - подвійнозігнутий
поден - поденник
подив - подив
подув - подувати
подут - подути подутися
подяк - подяка
подій - подієвий подійний подійність подія
подіт - подіти подітися
пожат - пожати пожатий пожатися
пождат - пождати
пожив - поживний поживність  високопоживний малопоживний малопоживність непоживний непоживність суперпоживний
пожит - пожити пожитися
пожов - пожований пожованість пожовувати
пожув - пожувати
позаков - позаковувати
позализ - позализувати
позаснов - позасновуваний позасновувати
позбув - позбування позбувати позбуватися
позбут - позбути позбутися
поздув - поздувати
поззув - поззувати
позив - позив позивний
позик - позика позичка
позлиз - позлизувати
позлит - позлити позлитися
позліш - позлішати
познач - позначка
позниз - познизувати
позов - позовний
пойнят - пойняти
покер - покер покерний
поклик - поклик
покльов - покльований покльовування покльовувати
поклюв - поклювати
поков - покований
покрив - покрив покривний покривність    безпокривний
покрик - покрик
покрит - покрити покритися
покрів - покрівець покрівний покрівський
покрій - покрій
покув - покувати
покій - покій покійний покійник покійниця    непокій непокійний
покіст - покіст
полив - полив поливний  неполивний післяполивний
полит - полити политися
полк - полковий
поллят - полляти поллятися
полувал - полувальний
полюв - полювальний полювальник полювальниця полювання полювати полюватися  псевдополювальник
поляр - біполярний біполярність
полярон - біполярон
полівіш - полівішання полівішати
полік - полікувати полікуватися
полінов - полінований
поліном - поліном поліноміальний поліномний
поліолов - поліоловий
політер - політерний
політес - політес
політок - політок
поліч - полічений
пом'ят - пом'яти пом'ятися
помит - помити помитися
помліт - помліти
помор - помор
поміст - поміст помістя
поміч - помічний   безпомічний безпомічність непомічний псевдопомічний самопомічний
поміш - помішати помішатися
понавіш - понавішати
понадріз - понадрізувати
понаниз - понанизувати понанизуватися
понапльов - понапльовуваний понапльовувати
понапув - понапувати
понаріз - понарізувати понарізуватися
понасов - понасовувати понасовуватися
понасув - понасуваний понасувати понасуватися
понасій - понасіюваний
понахов - понаховувати
понит - понити
понов - поновний поновність  непоновний
понч - пончик
пообдув - пообдувати
пооблиз - пооблизувати пооблизуватися
пообріз - пообрізувати
пооддув - пооддуватися
поодріз - поодрізувати
поодсув - поодсуваний поодсувати
попит - попит попити  гіперпопит суперпопит телепопит
попльов - попльовувати
поплюв - поплювати поплюватися
попограт - попограти
попогріт - попогріти попогрітися
поподут - поподути
попождат - попождати
попожит - попожити
попозлит - попозлитися
попом'ят - попом'яти
попомліт - попомліти
попонит - попонити
попопит - попопити
попорен - попорений
попорот - попороти попоротися
попран - попраний
попрат - попрати
поприков - поприковувати
поприхов - поприховуваний поприховувати
попрок - попрок
попроріз - попрорізувати попрорізуватися
попріт - попріти
попсув - попсування попсувати попсуватися
попул - неопопулізм непопулістський
попхат - попхати попхатися
попхнут - попхнути
попідлиз - попідлизувати
попідсов - попідсовуваний попідсовувати
попідсув - попідсувати попідсуватися
попідсій - попідсіюваний
порей - порей
поржат - поржати
порив - порив поривний поривність
порит - порити поритися
пороздув - пороздувати
пороззув - пороззуваний пороззувати пороззуватися
порозкльов - порозкльовувати
порозков - порозковувати
порозріз - порозрізувати
порозсов - порозсовуваний порозсовувати
порозсув - порозсувати порозсуватися
порозсій - порозсіюваний
порок - порок
порцій - порційний порція
порічк - порічка порічковий
поріш - порішати
посклен - посклений
посков - посковувати
послів - послівний
посмик - посмик
посміт - посміти
поснов - поснований
поснув - поснувати
поснут - поснути
поспат - поспати поспатися
поспів - поспів поспівка
поспіт - поспіти
поспіш - поспішати поспішатися
посрат - посрати
поссат - поссати
пост - постовий
пост - постувальник
постарш - постаршати
постаршин - постаршинувати
поствор - постворювати
постел - постелька
постол - постоловий
постриб - пострибування
постриб - пострибування
пострив - постривати
постриг - постриг пострига постригання
постриг - постригати постригатися постригти постригтися
постриж - пострижений постриженик постриження
поструг - поструганий
поструг - постругати
поструш - пострушуваний пострушувати
постріл - постріл пострілювання
постріл - пострілювати постріляти пострілятися
поступал - поступальний поступальність
поступл - поступливий поступливість
поступов - поступовання поступовець поступовий поступовість
постіл - постіл постіль постілька постільний постільниця
посув - посуваний посування посувати посуватися
посхн - посхнути
посцят - посцяти
посів - посів посівний   післяпосівний
потер - потерти потертися потертість
потерч - потерча
потка - поткати
поткнут - поткнути поткнутися
потліт - потліти
потон - потонути
потік - потік потічок  авіапотік автопотік аудіопотік аудіопотічок відеопотік газопотік електропотік кінопотік нафтопотік телепотік
потіш - потішати потішатися
поусув - поусувати поусуватися
похиз - похизуватися
похит - похит
похов - похований поховання    біопоховання екопоховання непохований непохованість
почат - почати початий початися    непочатий непочатість
почин - почин
почув - почування почувати почуватися   самопочування
почут - почути почутися
пошив - пошивний
пошит - пошити пошитися
превал - превалювання
прибра - прибраний прибрання прибрати прибратися    неприбраний
привал - привал привалений привалюваний привалювання
пригн - пригнутий
пригнан - пригнаний пригнати пригнатися
пригнит - пригнити
пригнут - пригнути пригнутися пригнутий
пригорн - пригорнений пригорнутий
приграт - приграти
пригрів - пригрів
пригріт - пригріти пригрітися
прида - придати придатися
придан - придане приданий придання
придув - придувати
призван - призваний призвання
призват - призвати призватися
призвіст - призвістка
призм - біпризма біпризмовий
призна - признаний признання    напівпризнання
признат - признати признатися
признач - призначка
прийт - прийти прийтися
приключ - приключка
приков - прикований прикованість приковування приковувати приковуватися
прикрит - прикрити прикритися
прикув - прикувати прикуватися прикути
прилив - прилив приливний
прилиз - прилизування прилизувати
прилит - прилити
прим'я - прим'яти прим'ятися
прим'ят - прим'ятина
примат - примат
примкн - примкнений примкнення примкнутий
примкну - примкнути
примліт - примліти
примоч - примочка
примча - примчати примчатися
приміст - примістка
приміш - примішати примішатися
припал - припалювання
приперт - припертість
приперіз - приперізування
припин - припин
припн - припнутий
припха - припханий
припій - припій припійний
припік - припік припічка припічок
присла - присланий прислання
прислів - прислівний прислівник
присмак - присмачка присмок
присмал - присмалювання
присов - присовування
присок - присок
приспа - приспаний приспаність приспання
приспів - приспів приспівка
присса - приссати приссатися
приста - пристання
приста - пристання пристати
присув - присування
присхн - присхнути
присій - присіюваний
присін - присіння
притик - притик притика притичка притичний   непритика
приткн - приткнутий
притч - притча    кінопритча
притят - притяти
прихов - прихований прихованість приховання приховуваний приховування приховувач приховувачка    малоприхований малоприховуваний напівприхований напівприхованість неприхований неприхованість неприховуваний
причал - причальний причалювання    безпричальний безпричальність
причув - причуватися
причут - причутися
пришив - пришивний
пришит - пришити пришитися
пришл - пришлий пришлість
пришов - пришовний
пробив - пробивний   непробивний непробивність
пробій - пробій пробійний пробійник пробійність   непробійний
провал - провальний провальність провалювання    безпровальний безпровальність безпровиння непровальний
провесн - провесняний
провій - провіюваний провіювання
провіс - провість
прогер - прогерія
прогин - прогин
прогнан - прогнаний прогнання
прогнат - прогнатичний
прогнут - прогнутий прогнутість
прогній - прогній
програн - програний    непрограний
програт - програти програтися
прогрів - прогрів
прогріт - прогріти прогрітися
продран - продраний
продув - продувальний продуваний продування
прожат - прожатий
прожда - прождати
прожер - прожерний
прожит - прожити
прожов - прожований    напівпрожований
прожов - прожовування прожовувати прожовуватися
прожув - прожувати прожуватися
прозва - прозваний прозвання прозвати прозватися
прозна - прознати
прозрі - прозріння
прокат - прокат    автопрокат велопрокат вібропрокат відеопрокат кінопрокат телепрокат
прокльов - прокльований прокльовування
проков - прокований проковування
прокрохмал - прокрохмалений прокрохмалюваний прокрохмалювання
пролив - проливний
пром - промка    авіапром авіапромівський автопром агропром вуглепром радіопроміння
промер - промерський
промес - промеса
промив - промивний промивність   вуглепромивний
промкн - промкнутий
промін - проміння проміннячко
пронат - пронаторний
пронац - пронаційний
прониз - пронизувальний пронизування
пропал - пропалювання
пропран - пропраний
пропретор - пропретор
пропріал - пропріальний
пропій - пропій пропійний
прорва - прорваний прорвання
прорва - прорваний прорвання прорвати прорватися
прорив - прорив проривний    кінопрорив суперпроривний
пророк - пророк лжепророк псевдопророк
проріз - прорізувальний прорізування
проріст - проріст прорість
прос - просище  просо
просал - просалювання
прослан - просланий
просмал - просмалювання
просов - просовування
проспан - проспаний
прост - напівпростий непростий простий простість
простат - простатичний
просув - просувальний просування просувач просувачка
просув - самопросування
просів - просівний
просій - просіювальний просіюваний просіювання
просік - просіка  просічний
просіон - просіоністський
протез - протез протезний       біопротез кіберпротез
протик - протикання
протир - протиральний протирання
протистой - протистояння
протистой - протистояння
проткан - протканий
проткат - проткати
проткну - проткнутий проткнути проткнутися
протліт - протліти
протокол - протокол протоколізм протоколіст протоколістка протокольний протокольність протокольований протоколювання
протон - протонований
протоп - протоплений протоплюваний
протор - проторений
протор - проторований проторованість
проточ - проточений
проточ - проточина
проточ - проточування
протрал - протралювання
протруй - протруювання
протік - протік протічний  непротічний
прошив - прошивний прошити
путч - путч путчевий путчист путчистський   післяпутчевий
півдесятин - півдесятина півдесятинка
півплощин -  півплощина
підбал - підбалка
підбив - підбивний
підбит - підбити підбитися
підбор - підбор
підбрит - підбрити підбритися
підбій - підбій підбійка підбійний
підвал - підвальний    безпідвальний напівпідвальний
підверн - підвернений підвернутий
підвит -  підвити підвитися
підгнит - підгнити
підгній - підгнійний
підгорн - підгорнений підгорнутий
піддан - підданий піддання    безпідданий
піддат - піддати піддатий піддатися
піддув - піддувало піддувальний піддування піддувати піддуватися
піддут - піддути піддячий
піддів - піддівка
піджак - піджак піджаковий
піджач - піджачок
піджив - підживний
піджин - піджин піджинізований
піджит - піджити
підкат - підкат
підкльов - підкльований підкльовуваний підкльовувати
підклюв - підклювати
підков - підкований підкованість підковний підковувальний підковування підковувати підковуватися    непідкований непідкованість суперпідкований
підкрохмал - підкрохмалений підкрохмалюваний підкрохмалювання
підкув - підкувати підкуватися
підків - підківка
підлив - підливний
підлиз - підлизування підлизувати підлизуватися
підлит - підлити підлитися
підмал - підмалювання
підмив - гідропідмив
підмит - підмити підмитися
підмор - підмор
підморатор - підмораторний
підміш - підмішати підмішатися
піднят - підняти піднятися
підпал - підпальний підпалювання
підпит - підпити
підпсов - підпсований
підпсув - підпсуват
підпіч - підпічок
підрив - підрив підривний    радіопідривний самопідрив
підрит - підрити підритися
підріз - підрізування підрізувати підрізуватися
підріст - підріст
підс - підсалювання
підсал - підсалювання
підсерій - підсерія
підсмал - підсмалений підсмалювання
підсов - підсовування
підсов - підсовувати підсовуватися
підсув - підсування
підсув - підсувати підсуватися
підсів - підсівний
підсій - підсіння
підсіч - підсічний
підточ - підточка
підтят - підтяти підтятися
підхвал - підхвалений підхвалюваний підхвалювання
підчал - підчалення підчалок підчалювання
підшив - підшивний
підшит - підшити підшитися
підігн - підігнутий
підігнан - підігнаний підігнаність підігнання
підігнат - підігнати підігнатися
підігнут - підігнути підігнутися підігнутий
підігран - підіграний
підіграт - підіграти
підігрув - підігрування підігрувати
підігрів - підігрів підігрівний підігрівник    водопідігрівник газопідігрівник електропідігрів
підігріт - підігріти підігрітися
підійт - підійти
підім'ят - підім'яти підім'ятися
підіпріт - підіпріти
підісрат - підісрати
підітн - підітнутий
підітнут - підітнути підітнутися
піклув - піклувальний
пінеал - пінеальний
пірамід - біпіраміда біпірамідний
пірат - пірат піратка  аудіопірат біопірат відеопірат кінопірат радіопірат
піринг - піринговий
пірит - пірит
пісок - пісок пісочок
пісян - пісяння
пісят - пісяти пісятися
пітч - пітчер пітчерський пітчинг пітчинговий
рабин - рабин
радж - раджа
радик - бірадикальний
радикал - бірадикал
радян - неорадянський
радіал - радіальний радіальність  нерадіальний
радіатор - радіатор радіаторний  електрорадіатор
радіац - радіаційний радіація  мікрорадіація нерадіаційний післярадіаційний пострадіаційний протирадіаційний
радій - радієвий радій радійний
ревіз - ревізія ревізований ревізування
резон - резонерствувати
рейнджер - рейнджер
ректор - ректор ректорка ректорство ректорський    віцеректор ексректор
реліг - неорелігійний неорелігія
рибекіт - рибекіт рибекітовий
римес - римеса
рислінг - рислінг
рисосій - рисосіяння рисосійний
родій - родієвий родій родіювання
розбив - розбивний
розбит - розбити розбитися
розбій - розбій розбійний розбійник розбійниця
розвал - розвалювання
розвив - розвивний     нерозвивний
розвит - розвити розвитися
розвій -   саморозвій
розвій - розвій  розвіювання
розвік - розвіюваний
розвіш - розвішати
розгріш - розгрішати
роздан - розданий
роздат - роздати роздатися
роздув - роздувальний роздувальниця роздування роздувати роздуватися
роздут - роздути роздутися
розенкрейцер - розенкрейцер розенкрейцерівський
розжит - розжитися
розжов - розжований розжованість розжовування розжовувати розжовуватися
розжув - розжувати розжуватися
роззув - роззування роззувати роззуватися
роззут - роззути роззутися
розкльов - розкльований розкльовування розкльовувати розкльовуватися
розклюв - розклювати розклюватися
розков - розкований розкованість розковування розковувати
розкрив - розкривний    нерозкривний саморозкривний
розкрит - розкрити розкритися
розкрій - розкрій розкрійний розкрійник розкрійниця
розкув - розкувати розкуватися
розкут - розкути
розлив - розлив розливний
розмал - розмалювання
розмив - розмив розмивний розмивність    гідророзмив
розмин - розмин
розмич - розмичка
розмов - розмовний розмовність   нерозмовний
розмоч - розмочений розмочення розмочування
розмочал - розмочалювання
розпал - розпалка розпальний розпалювання
розпач - розпач
розпит - розпит
розрив - розрив розривний розривність    гідророзрив нерозривний нерозривність
розріз - розрізальний розрізувальний розрізування
розріст - розріст
розсов - розсовуваний розсовування розсувальний розсування
розста - розстання
розсів - розсів розсівний   нерозсівний
розсій - розсійник розсіювальний розсіюваний розсіювання    звукорозсіювальний звукорозсіювання радіорозсіювальний
розтин - розтин
розтлі - розтління
розтят - розтяти розтятися
розтік - розтік розтічний розтічність
розхвал - розхвалений розхвалюваний розхвалювання
розчал - розчалка розчалювання
розчат - розчатий
розчин - розчин    спецрозчин
розшив - розшивний
розігнут - розігнутий розігнутість
розійт - розійтися
розім'я - розім'яти розім'ятися
романт - неоромантизм неоромантик неоромантичний
ротат - ротативний ротатор ротаторний
ротац - ротаційний ротація  неротаційний радіоротація телеротація
ротув - ротувати ротуватися
русал - русальний
салат - салат салатка   біосалат
салінг - салінг
санатор - санатор санаторій санаторний санаторник санаторниця санаторський  держсанаторій спецсанаторій теплосанаційний
санац - санаційний санація   теплосанація термосанація
сапер - сапер саперка саперний саперський
сварадж - сварадж свараджист свараджистка
свояк - своячка своячок
севрюг - севрюга севрюговий
сегмент - бісегментація
секс - бісексуальний бісексуальність
сексуал - бісексуал бісексуалізм бісексуалка
семисот - семисотий
сеньйор - сеньйор
синто - синтоїзм синтоїст синтоїстка синтоїстський
синхрон - бісинхронний
синьйор - синьйора синьйорія синьйор
синьогній - синьогнійний
синьоочка - синьооч
синьошерст - синьошерстий
систол - бісистолія
ситуат - ситуативний
ситуац - ситуаційний ситуація   екоситуація кіноситуація
скарлатин - скарлатина скарлатинний скарлатиновий
скет - скетч    мікроскетч
скльов - скльований скльовувати
скні - скніння скніти
скотч - скотч
скрик - скрик
скрин - скриня
скрит - скрити скритися
смокінг - смокінг
сміл - сміливенький сміливець сміливий сміливиця сміливість смілість сміливий
сміттєспал - сміттєспалювальний сміттєспалювання сміттєспалювач
согріш - согрішати
сонц - сонце
сопк - сопка сопковий
сопл - сопливий сопливість соплячка
сором - сороміцький
соціонік - соціоніка
соціоніч - соціонічний
спал - газоспалювальний газоспалювання
спал - самоспалений самоспалення самоспалювання
спектр - біспектр біспектральний
спльов - спльовування спльовувати
спляч - сплячий сплячка    напівсплячий несплячий
сполосн - сполоснутий
співанк - співанковий
співомов - співомовка
спір - біспіральний
стабіл - бістабільний
старов - старовизна старовина старовинний старовинність
старост - староство
старост - старостиха
стредж - стреджинг
стретч - стретчинг
стрий - стрий
строк - строк
стрюк - стрюкуватий
стрі - стріти стрітися
стрій - стрій  однострій
субсид - субсидійний субсидійований субсидіювання субсидія субсидований субсидованість субсидування субсидувати субсидуватися
субстрат - субстрат
субтил - субтильний субтильність
субчик - субчик
сульф - бісульфат
сульфіт - бісульфіт бісульфітування
сумо - сумоїст сумоїстка
суперстрат - суперстрат
сухокост - сухокостий
суягн - суягна суягність
сфер - бісферичний
схвал - схвальний схвальність схвалювання схвалений схвалення схвалюваний    несхвалений несхвалення несхвальний несхвальність
сірковипал - сірковипалювальний сірковипалювання
табу - табуйований табуйованість табуювання
тальк - тальковий
талій - талієвий талій талійка талія
танк - танковий  протитанковий
тату - татуйований татуювальник татуювальниця татуювання
тей - теїст теїстичний теїстичність теїстка теїзм мототеїзм автотеїзм
телятин - телятина телятинка
тем1 - тема тематичний темка
тепл - тепловий
термовідпал - термовідпалювання
термоліт - термолітичний термолітовий
термопот - термопот
терор - терор  антитерор біотерор
терцій - терційний терція
технар - технар технарський
технік - технік техніка технікиня технікум
техніч - технічка технічний технічність
тинейдж - тинейджер тинейджерка тинейджерство тинейджерський
тисяч - тисяцький тисячка
толстов - толстовець толстовка толстовство толстовщина толстовський
томат - томат
тон - бітональний бітональність
тонкорек - тонкорекція
торфоспал - торфоспалювання
тоталітар - неототалітаризм неототалітарний
трахе - трахеальний трахейний трахея    безтрахейний
триб - триб триба трибовий трибок
трив - тривання
тривог - тривога тривожний тривожність
тривож - тривожити тривожитися
тригер - тригер тригерний
тригон - тригон тригональний
трилер - трилер трилерний
тримач - тримач
тринадц - тринадцятий тринадцятка
трином - трином триномічний триномний
трипан - трипановий
трирем - трирема
трисел - трисель
трок - трок
трьохсот - трьохсотий трьохсотка
тубов - турбований
тубсанатор - тубсанаторій
тьютор - тьютор тьюторка
тятив - тятива тятивний
тікток - тікток тіктокер тіктокерка тіктоківський
тінейдж - тінейджер тінейджерка тінейджерство тінейджерський
увертюр - увертюра
увігнут - увігнутий увігнутість
угнут - угнутість    неугнутість
удосконал - удосконалений удосконалення удосконалюваний удосконалювання удосконалювач удосконалювачка    неудосконалений
укрив - укривний
укрит - укрити укритися
ультраліт - ультраліт
ум'я - ум'яти ум'ятися
ум'ят - ум'ятина
услан - усланий
услат - услати услатися
уст - устя устячко
устал - усталювання
устій - устійний устійник
ухвал - ухвальний ухвальність ухвалювання
фаз - біфазний
фас - біфасіальний
фаш - неофашизм неофашист неофашистка неофашистський
фелюг - фелюга
феодал - неофеодал неофеодалізм неофеодальний
фероплатин - фероплатина фероплатиновий
фероплин - фероплин
фок - біфокальний біфокальність
фокус - біфокусний
фольклор - неофольклоризм неофольклористичний
фотоліт - фотолітичний
фотонаст - фотонастія
фотонік - фотоніка
фотонік - фотоніка
функ - біфункція
функціон - біфункціональний
хадж - хадж
харадж - харадж
харидж - хариджит
хвіст - двохвістка
хедер - хедер
хедж - хедж хеджер хеджований хеджування хеджувати хеджуватися
християн - неохристиянин неохристиянство неохристиянський
хром - біхромат біхроматичний
хромат - біхроматний
хроматометр - біхроматометричний біхроматометрія
цикл - циклювальний циклювання циклювати циклюватися
ціл1 - цілунок цілований цілувальний цілувальник цілувальниця цілування
частот - бічастота бічастотний бічастотність
чор - чорновий
чорнобиль - чорнобиль чорнобильник
чорнобрив - чорнобривчик чорнобровий
чотирьохсот - чотирьохсотий
шелюг - шелюг шелюга шелюговий шелюгування
шеринг - шеринговий
шестисот - шестисотий
шулік - шуліка шулічий
щоден - щоденник    відеощоденник радіощоденник суперщоденник телещоденник фотощоденник
юр - юрист юристка юридичний юридичність
ядер - біядерний
якіс - якість
єдинокров - єдинокровний єдинокровність
ікономал - ікономалювання
імпер - авіаімперія
імідж - імідж іміджевий   телеімідж
інстал - інстальований інстальовний інстальовність інсталювання інсталятор інсталяційний інсталяція    аудіоінсталяція відеоінсталяція кіноінсталяція фотоінсталяція
інтеркал - інтеркальований інтеркалювальний інтеркалювання інтеркаляційний інтеркаляція
інтерстиц - інтерстиційний
